F 250,135,206
  C    110,,0,0


NO textures/north.xpm
SO textures/south.xpm
WE textures/east.xpm
EA textures/west.xpm


111111111111111
111111000111111
11111000110011111
1111000N0001111
111000000000111
1100000000000111
100001111100001
110000111000011
111000010000111
111100000001111
111110000011111
111111000111111
111111111111111
