F 250,135,206
  C      0,0,0


NO textures/north.xpm
SO textures/south.xpm
WE textures/east.xpm
EA textures/west.xpm


11111111111
10000000001
10N00000001
10000000011
11111111111