F 250,135,206
C 99,99,42


NO textures/7it2.xpm
SO textures/7itlkhr.xpm
WE textures/7itakhor.xpm
EA textures/7it3.xpm



111111111111111
111111N00011111
111111111111111


