F 250,135,206
C 99,99,42


NO textures/7it2.xpm
SO textures/7itlkhr.xpm
WE textures/7itakhor.xpm
EA textures/7it3.xpm


111111111
100000001
100000001
10N000001
100000001
111100001
110000011
100000001
111111111
