F 250,135,206
C 99,99,42


NO textures/7it2.xpm
SO textures/7itlkhr.xpm
WE textures/7itakhor.xpm
EA textures/7it3.xpm


111111111111111
111111000111111
111110000011111
1111000N0001111
111000000000111
1100000000000111
100001111100001
110000111000011
111000010000111
111100000001111
111110000011111
111111000111111
111111111111111   